# Put your config here.

# For test and debug.
:debug:		false
:test:		false
:verbose_mode:	false

# Server setting.
:user:		nobody
:group:		nobody
:bind_address:	0.0.0.0
:web_port:	9190
:ml_port:	9195

# Public Web address.
:public_url:	http://example.com/
:default_sitename:	www

# Mailing list setting.
:ml_domain:	example.com
:ml_postmaster:	postmaster@example.com

# Send mail setting.
:smtp_host:	127.0.0.1
:smtp_port:	25

# Extra setting.
# For Graphviz plugin.
:graphviz_dot_path:	/usr/bin/dot
:graphviz_font_size:	10
:graphviz_font_name:	Sazanami Gothic

# Mailing list server setting.
:sweep_interval:	3600
:allowable_error_interval:	8600
:max_threads:		10		# Number of working threads.
:timeout:		120
:use_qmail_verp:	false
:confirm_ml_creation:	false

# Default group setting.
:auto_unsubscribe_count:	5
:max_mail_length:	100 * 1024	# 100KB
:max_ml_mail_length:	100 * 1024	# 100KB
:max_members:		100
:ml_alert_time:		86400 * 24
:ml_life_time:		86400 * 31

# Setting for development mode.
:lib_dir:	$BASEDIR/lib
:qwiklib_dir:	$BASEDIR/lib/qwik
:sites_dir:	$BASEDIR/data
:grave_dir:	$BASEDIR/grave
:cache_dir:	$BASEDIR/cache
:super_dir:	$BASEDIR/share/super
:theme_dir:	$BASEDIR/share/theme
:template_dir:	$BASEDIR/share/template
:qrcode_dir:	$BASEDIR/share/qrcode
:etc_dir:	$BASEDIR/etc
:config_file:	$BASEDIR/etc/config.txt
:pass_file:	$BASEDIR/etc/password.txt
:generation_file:	$BASEDIR/etc/generation.txt
:log_dir:	$BASEDIR/log
:web_error_log:	$BASEDIR/log/qwik-error.log
:web_access_log:	$BASEDIR/log/qwik-access.log
:access_log:	$BASEDIR/log/access.log
:ml_log_file:	$BASEDIR/log/quickml.log
:web_pid_file:	$BASEDIR/log/qwikweb.pid
:ml_pid_file:	$BASEDIR/log/quickml.pid

# Setting for production mode.
#:lib_dir:	/usr/lib/ruby/1.8
#:qwiklib_dir:	/usr/lib/ruby/1.8/qwik
#:sites_dir:	/var/lib/qwik/data
#:grave_dir:	/var/lib/qwik/grave
#:cache_dir:	/var/cache/qwik
#:super_dir:	/usr/share/qwik/super
#:theme_dir:	/usr/share/qwik/theme
#:template_dir:	/usr/share/qwik/template
#:qrcode_dir:	/usr/share/qwik/qrcode
#:etc_dir:	/etc/qwik
#:config_file:	/etc/qwik/config.txt
#:pass_file:	/etc/qwik/password.txt
#:generation_file:	/etc/qwik/generation.txt
#:log_dir:	/var/log/qwik
#:web_error_log:	/var/log/qwik/qwik-error.log
#:web_access_log:	/var/log/qwik/qwik-access.log
#:access_log:	/var/log/qwik/access.log
#:ml_log_file:	/var/log/qwik/quickml.log
#:web_pid_file:	/var/run/qwik/qwikweb.pid
#:ml_pid_file:	/var/run/qwik/quickml.pid
